lLLllWwwFE
----------
----------
FfF--LllLP
----------
----------
wW--LlLLLR
w----FfFFf
W---------
R---------
--wWwLlWPP
--LLFfFLlL
----------
LllLLlWwW-
FffFWFRRL-
X---------